@@@@@@@@@@@@@@@@@@@@@@@@@@@@@
@.........@.@...............@
@.@.@@@@@.@.@.@@@@@.@@@@@.@@@
@.@.@.@...@...@.....@.....@.@
@@@.@.@@@.@@@@@.@@@@@.@@@@@@@
@.....@.....@.@.@.....@.....@
@.@@@@@@@.@@@.@.@.@@@@@@@.@@@
@...@...@.@.@...@.@.....@...@
@@@.@.@.@.@.@.@@@.@@@.@.@.@@@
@...@.@.@.....@.@.@...@.....@
@@@@@@@@@@@@@@@@@@@@@@@@@@@@@
